#iitb entries	iitb
3rd	wIsarA
Abhimanyu's	aBimanyu
Agni	agni
Ah	Aha
Ahh	Aha
Arjun's	arjuna
Arjuna	arjuna
Brahmi	brAhmI
De-grime	dI-grima
Dhritarashtra's	XqwarARtra
Dhrstaketu	XqRtakewu
Dhrtarastrah	XqwarARtra
Dronacharya's	xroNAcArya
Duryodhan	xuryoXana
Duryodhana	xuryoXana
Fig.	ciwra
Ganga	gafgA
Granduncle	piwAmaha
Gudaka	gudAkA
Gudakesa	gudAkeSa
Kalinga	kaliMga
Kasiraja	kASirAja
Kaurav	kOrava
Krishn	kqRNa
Maharashtra	mahArARtra
Maitrakas	mEwrakasa
Manu	manu
Pandav	pANdava
Pandu	pANdu
Ramachandra	rAmacanxra
Saibya	SEbya
Sanjaya	saFjaya
Shantanu	SAnwanu
Tambe	wAmbe
Urvashi's	urvaSI
Vichitravirya	viciwravIrya
Ya	ya
a	prawi/kisI
ability	xakRawA
above	uparokwa
academic	SEkRaNika
accelerated	wvayariwa
access	eksesa
accomplishments	upalabXiyAM
accountability	jabAvaxehI
accrued	upArjiwa
accuracy	satIkawA
accurate	satIka/saha
aces	esIIesa
acetic	esItika
achieve	hAsila_kara
acid	kRArIya
acquire	arjiwa
acquisition	aXigrahaNa
act	kAnUna
activities	gawiviXiyAM
activity	EktivitI/kriyAkalApa
actuarial	bImAfkikIya
additional	awirikwana
adjourning	sWagana_kara
administered	praSAsiwa
administrative	praSAsana
adolf	edoYlPa
advanced	AXunika
adventurous	sAhasI
adverse	viRama
advertised	vijFApiwa_kara
affectionate	priya
affidavit	SapaWapawra
affirmations	puRtikaraNa
afghanistan	aPagAniswAna
agencies	ejeMsiya
agency	ejeMsI
agenda	ejeMdA/kArya-sUcI
agent	ejeMta
aggrieved	pIdiwa
agile	cuswa/ejAila
agree	sahamawa
agriculture	egrIkalcara
agro	kqRi
ahead	Age
ahh	Aha
air-conditioning	eyarakaNdISaniMga
airline	eyaralAina
akbar	akabara
alarm	alArma
alcohol	SarAba
all	sabakA/hara
allied	anya
allocation	AbaNtana
allot	AvaNtiwa
allowed	anumawi
aloud	jora-jora_se
alternative	xUsarI
although	hAlAzki
aluminium	elyUmIniyama
amalgamation	samAmelana
an	EsA/EsI/kisI/kisI_BI/koI_BI
analytical	viSlenaRaNAwmaka
ancillary	anuRafgI
and	eMda
andhra	AnXra
angry	kroXa
animal	paSupAlana
another	anya
answer	uwwaraH
anti-clockwise	vAmAvarwa
any	kisI
anytime	kaBI_BI
apollo	apolo
apparel	pariXAna
applicable	sakriya
application	eplikeSana/Avexana
appoint	niyukwi
appraisals	mUlyAfkana
approach	xqRtikoNa
approval	maFjUrI
approved	svIkqwa/anumoxiwa/maFjUrI
archaeologist	purAwawvavix
are	hE
area	ilAkA
argue	warka
aristotle	araswu
army	senA
arrested	giraPwAra
artistry	kalA-kOSala
arunachalam	aruNAcalam
as	jEsA_ki/Ora
asana	Asana
ascertain	niScaya
asp-style	eesapI-SElI/eesapI-stAila
aspiring	AkAfkRI
assertively	xqDawApUrvaka
asset	pa
assets	parisampawwiya/parisampawwiyAM
assignment	asAinameMta
assistance	sahayoga
associated	sambaxXa
association	esosieSana
asthma	asWamA
atherosclerosis	eWerosklerosisa
atra	awra/awrA
attachment	Asakwi/atEcmenta
attack	hamalA_kara
attacking	hamalA_kara
attendant	paricara
attitude	pravqwwi
audience	xarSaka
audio	oYdiyo
audio-visual	Sravya-xqSya
audit	leKAparIkRA
authentication	aBipramANana
authorised	mAnya
authority	aWoYritI/prAXikaraNa/aXikaraNa
authorization	oYWarAijeSana
automated	svacAliwa
automatic	svawaH
automobile	oYtomobAila
automobiles	oYtomobAila
automotive	oYtomotiva
available	nakalI/upalabGa
avanti	avanwi
aviation	vimAnana
avoid	tAla_xe
await	prawIkRA_kara
awaken	jAgqwa_ho
backspace	bEkaspesa
backup	bEkaapa
backwards	pICe_kI_waraPa
bad	burI
badly	burI_waraha
bank	bEka
banking	bEMkiMga
bargaining	sOxebAjI
basal	AXAra
basic	prAramBika
battle	yuxXa/yuxXa_kara
battlefield	yuxXaBUmi
bauxite	boYksAita
be	hE
bearing	promisarI
beautiful	KUbasUrawa
before	ke_pUrva
beg	mAzga_kara
begin	hone_laga/SurUAwa
begins	SurUAwa
behave	vyavahAra
behavioral	vyavahArika
being	hewu
belonging	sambanXiwa
below	nIcA
belt-buckle	belta-bakala
benefit	lABaH
benefitted	lABAnviwa
bengal	bafgAla
best	uwkqRta
better	SreRTa/behawara_warIkA
big	badI
bigger	badI
bilingual	xviBARIya
bills	huNdiyAM
bio-diversity	jEva-viviXawA
bio-fuel	bAyo-IMXana
bio-fuels	bAyo-IMXana
bitter	kadavI
black	kAlI
bless	rakRA_kara
blind	anaBijFa
blossom	moYnasUna
blue	nIlI
boar	sUara
boarding	bordiMga
bole	bole
bond	riSwA
bonded	bANdayukwa
bonds	bANda
bones	haddiyAM
boomers	bUmarsa
bordeaux	boradoYksa
born	janma_ho
borrow	uXAra
borrowing	uXAra
both	xonA
boundless	sImAhIna
bouquets	puRpagucCa
bowman	XanurXara
boyfriend	boYiPrenda
braces	bresesa
brackish	namakIna
brainstorming	buxXiSIlawA
breath	sAMsa
breathing	sAzsa
breeding	prajanana
bride	vaXU
briefly	safkRipwa
brilliant	wejasvI
broad	vqhawa
broadly	mOte_wOra_para
buddhist	bOxXa
budgetary	bajatIya
buffalo	BEMsa
builders	nirmANakarwA
built	nirmiwa
bullet	buleta
burn	jala_raha
business	bijanesa/vyAvasAyika/kArobArI/vyApArI
butadiene	byUtAdAina
c-dac	sI-dEka
cabin	kebina
calculated	parikalanA
call	kahalA
calmly	SAnwa_svaBAva_se/SAzwi_se
camping	kEMpiMga
campus	kEMpasa
camsa-kalaahpumsah	cAMSakalAH
canonical	kEnonikala
cant	sahAyawA
capital	kEpitala/pUFjI
career	kariyara
carefully	XyAna_se/XyAnapUrvaka/sAvaXAnIpUrvaka
carelessly	lAparavAhI
cargo	kArgo
castor	kAstara
casual	kEjuala
catalogue	ketaloYga
category	SreNI
cause	uwpanna_ho
celebrate	jaSna_manA
celebrity	prawiRTiwa
central	mahawvapUrNa
centrally	keMxrIya
certainly	niScaya_hI
certified	pramANiwa
challengers	cEleMjarsa
challenges	cunOwiyAM
challenging	cunOwIpUrNa
chanakya	cANakya
changed	parivarwiwa
characteristics	guNa
charged	praBAviwa
charges	KarcA
chart	cArta
cheap	saswI
check	jAzca_kara/mUlyAfkana_kara
child	bAlaka
child-friendly	miwravawa
chilli	mircI
chocolate	coYkaleta
cholesterol	kolestrola
chunk	BAga
civil	sivila
clang	klEMga
clashes	takarAva
claw	kloY
clean	spaRta
clear	sAPa-sAPa
clearly	spaRta/spaRta_rUpa_se
clears	maFjUra
clients	klAiMtsa
climber	parvawArohI
clonal	klonala
cm	semI
co-operation	sahayoga
coaching	kociMga
coated	lepiwa
coating	kotiMga
coatings	kotiMga
cobra	kobarA
coca	kokA
cocoa	kokoA
coding	kodiMga
coercion	xabAva
coin	sikka
collaborative	sahayogAwmaka
collaterals	samAnAnwara
colleagues	sahayogI
collected	safgrahiwa
collectively	sAmUhika_rUpa
colonists	upaniveSavAxiya
combat	yuxXa
combined	sammiliwa/saMyukwa
commercial	vyAvasAyika
commitment	prawibaxXawA
committee	saMsAXana
communication	saMvAxa
community	kutumba/jAwi
companies	kampaniyAM
comparatively	apekRAkqwa
compassion	karuNA
compatible	susafgawa
compensation	kRawipUrwi
competitive	prawisparXI
completely	pUrI_waraha_se
component	safGataka
components	safGataka
composure	XErya
compulsory	ho-anivArya
computed	parikaliwa
computing	kampyUtiMga
concepts	parikalpanA
concerns	cinwA/sambanXiwa
conclusive	niRkarRAwmaka
conditional	saSarwa
conducive	anukUla
confectionery	koYnPekaSanarI
confident	AwmaviSvAsa
confidently	AwmaviSvAsa_ke_sAWa
confined	kanPAiMda
conflicts	takarAva
confusions	sanxeha
congenial	sahajIvI
congo	koMgo
connectivity	samparka
conquered	jIwa_le
conservation	aneka
considerate	vicAraSIla
consideration	prawiPala
consistent	safgawa
consolidated	samekiwa
conspicuous	suspakaRta
constantly	niranwara
constraints	bAXyawA
construct	banAye_jA
construction	banAvata
consultancy	kaMsalteMsI/parAmarSa
containers	kaNtenara
content	kaNteMta
contingencies	AkasmikawA
continuous	niranwara
continuously	niranwara
contribute	sahAyaka
control	niyanwraNAXIna/nivAraNa
controller	niyAmaka
convenient	suviXAnusAra
convention	kanveMSana
convergence	aBiliKiwa
convergent	kanavarjeMta
conversion	rUpAnwaraNa
converted	rUpAnwariwa
cooperative	sahayogapUrNa
coordinating	samanvaya
coordination	samanvaya
core	mUla/kora/muKya
corporate	koYporreta/nigamiwa
correctly	sahI-sahI
corresponding	waxanurUpI
cost-efficient	lAgawaxakRa
costlier	mahafge
counter	vixrohI
courteous	vinamra
covering	AcCAxana
create	pExA_kara
creation	prawi
creative	racanAwmaka
credentials	kredeMSiyala
credible	viSvaSasanIya
credit	kredita/qNa
creditor	qNaxAwA
creditors	qNaxAwA
critically	awyanwa
crop	upaja
cross	kroYsa
cross-sectional	anuprasWa_paricCexa
crucial	mahawvapUrNa
cultivators	Kewihara
culture	pAlana
currency	kareMsI
current	varwamAna
curse	aBiSApa
custodians	kastodiyana
d	xa
damaged	kRawigraswa
dark	anXakAramaya
data	Afkade
data-base	dAtAbesa
databases	banA
daughter	puwrI
day	roja
de-grime	dI-grima
dearest	priya
debate	carcA_kara
debentures	dibencara
decided	PEsalA_kara
decode	dIkoda
deepen	gaharAI
deeper	gaharAI_se
deferred	vilambiwa
defining	pAriBARiwa
degrade	apamAniwa_kara
degraded	vana/vikAsa
degree	swarIya
delegated	sOMpA_jA
deleted	hatA
deliberately	jAna-bUJa_kara/jAnabUJakara
delightful	Ananxamaya
deltoid	wrikoNAkAra
demi-official	arXa-AXikArika
democracy	prajAwanwra
democratic	lokawAnwrika
denial	asvIkqwi
denote	nirUpiwa_kara
department	viBAgIya
deposit	jama
depositors	jamAkarwA
derive	prApwa/vyuwpanna
desert	marusWala
designation	paxa
designations	paxanAma
designing	dijAiniMga
desire	icCA_raKa
desired	vAFCiwa
destroy	vinaRta_kara
destructive	vinASakArI
deterioration	girAvata
detox	viRaharaNa
devarsi	xevarRi
developers	devalaparsa
devotee	BagavaxBakwa
devotion	anurakwi/samarpaNa
diction	uccAraNa
different	alaga-alaga/Binna-Binna/viviXa
differently	alaga-alaga
difficult	kaTinAI/vikata
diligently	karmaTawApUrvaka
dimension	vimA
diplomat	rAjanIwijFa
direct	nirxeSiwa_kara/dAyarekta/sIXI
directly	prawyakRa_rUpa_se/sIXA
dirt	ganxagI
disagree	asahamawi/asahamawa
disciplined	anuSAsiwa
discovery	anvesaRaNa
disease-specific	roga-viSiRta
dislikes	nApasanxa
disorder	aswa-vyaswa
dissemination	prasAra/viswAra
dissipate	vinaRta_kara
dissolved	pAraxarSiwA
districts	jile
divergent	dAivarjeMta
diversified	viviXikqwa
divine	xEvIya/xivya
doctrinal	sExXAnwika
document	doYkyUmenta/kAgajAwa
documentary	doYkyumeMtarI
documentation	xaswAveja
documents	kAgajAwa
dominant	praBuwva
dominate	CA
donor	hissA-xAwA
doubtful	sanXigXa/asanxigXa
downloads	dAunaloda
downward	aXomuKI
draft	prArUpa
drafts	prArUpa
drastic	BArI
drawing	drAiviMga
dreamreads	drImarIdsa
driving	drAiviMga
drupada-putrena	xrupaxapuwreNa
dry	sUKa_jA
dumping	dampiMga
duplicate	duplIketa
duties	dyUtI
duty	dyUtI
dwell	vAsa_kara
dynamic	dAyanemika
e-commerce	I-koYmarsa
e-filing	I-PAiliMga
e-governance	I-gavarneMsa/I-SAsana
e-learning	I-aXigama
e-linkages	I-liMkeja
earlier	pahalA/pUrva
earned	upArjiwa
earner	arjaka
earthworms	keMcua
easier	AsAnI
eat	Bojana_kara
eco-friendly	anukUla
economy	miwavyayawA
eczema	ekjimA
educated	SikRiwa
educational	SikRA
educationist	SikRAvix
effecting	praBAvI
effective	asaraxAra
effectively	praBAvI_Dafga_se
effectiveness	praBAvaSIlawA/praBAvAwmakawA/praBAviwA
efficiency	kuSalawA
efficiently	kuSalawApUrvaka/kuSalawA_se
effluent	pravAha
either	xonA
elasticity	lacIlepana
electrical	bijalI
electrically	vExyuwa
electronic	ilektroYnika
electronic-commerce	vixyuwa-vANijyika
electronically	ilektroYnika_rUpa_se
electronics	ilektroYniksa
element	Gataka
eligibility	yogyamawA
eligible	hakaxAra/pAwra
elimination	unmUlana
elusive	BrAnwijanaka
email	Imela
embarrassed	SarmiMxagI
embellishments	eMbeliSameMtsa
emerge	UBara_kara
emergency	ApAwakAlIna/emarajensI
employer	niyokwA
enabling	sAmarWyakArI
encoding	inakodiMga
encountered	sAmanA
encourage	praoVwsAhiwa_kara
encryption	enakripSana
end	samApwa
endeavour	prayAsa
enemy	xuSmana
energetic	UrjAvAna
enforceability	pravarwanIya
enforceable	pravarwana/pravarwanIya
engaged	juda
engineering	iMjIniyariMga
enquired	pUCawACa_kara
enquiries	pUCawACaH
ensure	suniSiciwa_kara
enter	Gusa_jA
enthusiastically	uwsAha_se
entire	samaswa
entirely	pUrNawaH
entity	ikAI
entrepreneur	eMtaraprenara/uxyamI
entrepreneurial	uxyama
entrepreneurs	eMtaraprenarsa/uxyamI/uxyamiya
entrepreneurship	eMtaraprenarSipa/uxyamiwA
environment	mAhOla
environmental	paryAvaraNa
equal	barAbara
equally	samAnawA_se/samAna_rUpa
equipment	upaskara
equitable	nyoyociwa
errors	wruti
escorts	eskorta
esdp	IesadIpI
especially	viSeRa/KAsawOra_para/viSeRakara
establish	prApwa_kara
etc.	iwyAxi
eternal	sanAwana
etiquette	etiketa
even	wo_BI/waba_BI
every	hareka
everyday	xEnika
everyone	prawyeka
evidencing	sAkRyaga
evident	arWapUrNa
evil-minded	xurbuxXi
exact	satIka
examine	jAFca
excavation	ekskeveSana
excellent	SAnaxAra/uwkqoRtu
exceptional	axviwIya
excess	bahuwAyawa/yaWA
excessive	awyaXika
exchange	viniyama
exclusive	viSeRa
executive	kAryakArI
executives	aXikArI
exfoliation	eksaPolieSana
exile	nirvAsiwa_kara
existing	mOjUxA
expansion	viswAxara
expensive	mahafgI
experimental	prayogAwmaka
expertly	kOSala_se
explicitly	spaRta_rUpa_se
exploration	anveRaNa
external	bAhaya
extinguisher	agniSAmaka
factor	PEktara
failed	asaPala_raha
fall	kamI
fame	yaSa
fantastically	AScaryajanaka_rUpa
farmer	kqRaka
farmers	kqRaka
fast	PAsta
faster	wejI_se
fat	vasA
fathers-in-law	sasura
favour	kqpA_kara
favoured	manapasanxa
favourite	pasanxIxA
fear	Baya_ho
feedstock	PIdastAka
feel	mahasUsa_ho
fertilisers	urvaraka
fertilizers	urvaraka
fifth	pAFcavAM
fig.	PIga/Pigara
fight	yuxXa_kara
filtration	PiltreSana
financial	viwwa
financing	viwwapoRaka
fingers	ufgaliyAM
first	pahalI
firstly	sabase_pahale
fish	maCaliyAM
fishes	maCaliyAM
fit	Pita
five	pAFca
five-step	PAiva-stepa
fix	sWira_raha
flag	XvajA
flanges	PlEnjesa
flat	PlEta
floater	Plotara
floating	PlotiMga
flower	puRpa
fluently	XArApravAha
fluid	PlUida
fly	PlAI
focus	XyAna
following	nimnaliKiwa
fondly	pyAra_se
font	PoYnta
for	PoYra
forecast	BaviRyavANI_kara
forest	jIvajanwu
forests	jIva-janwu
form	PoYrma/sUwra
formal	PoYrmala
formally	OpacArika
format	PoYrmEta
formed	rUpa_le/nirmiwa
formula	PoYrmUlA
fortis	Portisa
forty-eight	adawAlIsa
forward	Age_kI_waraPa
fossilization	PoYsilAijeSana
fought	ladAI_lada
framework	Premavarka
fraud	XoKAXadI
free	niHSulka
frequently	bAra-bAra/akasara
friendly	miwrawApUrNa/xoswAnA/paryAvaraNa-miwra
friendship	miwrawA
frost	olA
fuel	wela
fugitive	Pyujitiva
full	Pula
fully	PullI
functioning	kAryacAlana/kAmakAja
functions	nirvahana
fundamental	mOlika
funds	niXiyAM/qNa
fur	samUra
gardening	bAgavAnI
gasoline	gesolAina
generally	sAmAnyawayA/Ama_wOra_para/samAnyawaH/sAmAnyaEwayA
generated	sqjiwa
generating	uwpAxana/sqjana
generation	janareSana/sqjana/uwpAsaxana
geologist	BU-vijFAnI
gestures	iSArA/hAva-BAva
get	karavAeMH
girl	bAlikA
global	viSva/vESvika
globalisation	vESvIkaraNa/nijI
goals	lakRyA
going	jAna
good	acCI/baDiyA
goods	vaswuraa
govern	niyanwriwa
governance	gavarneMsa
governed	SAsiwa
grading	grediMga
gradually	XIre-XIre
grandfather	piwAmaha
grandson	powa
granduncle	piwAmaha
graphically	grAPika_rUpa_se
graphics	ciwraleKa
greater	aXikAXika/badI
greenish	harA
grief	Soka
grinding	pisAI
gross	groYsa
grouping	samUhana
grow-out	gro-Auta
guarantee	gAraNtI
guide	meMtara
guideline	xiSAnirxeSa
gujarat	gujarAwa
guru	gurU
gurudev	guruxeva
hair	roMgatA
hairpin	heyarapina
hand	hEMda
handbag	hEMdabEga
handle	samBAla
handling	hEMdaliMga
handrail	hEMdralsa
happily	KuSI_se/prasannawApUrvaka
har	hara
harder	aXika
hardworking	mehanawI
harvesting	pExAvAra
hastings	hestiMgsa
hate	naParawa_kara
heart	kama
hello	hElo
helplessly	asahAya
hemoglobin	hemoglobina
hence	isIlie
henry	henarI
her	apanI
herbal	harbala/jadI-bUtA
herbs	jadI-bUtA
here	yahAz_para/yahAM
hereditary	AnuvAMSika
hero	yuxXavIra
heroic	vIra
herzberg	harjabarga
high	sarvAXika
high-value	ucca-mUlya
higher	hAyara/uccawara
highlight	cinhAfkiwa
hilly	pahAdI
hindustan	hiMxuswAna
hired	niyukwa_kara/kAma_para_raKa
his	apanA/apanI
holders	KAwAXAraka
holistically	samagra_rUpa_se
hollywood	hoYlIvuda
home	nivAsa
homeland	mAwqBUmi
honestly	ImAnaxArI
honor	gOravAnviwa
honored	sammAniwa_kara
honourable	pUjanIya
hope	ASA_ho
house	hAusa
however	hAlAfki/lekina/yaxyapi/kiMwu
huge	BArI/kAPI
humble	vinamra/aBimAna-rahiwa
humidity	ArxrawA
hunch	Juka
hunting	SikAra_kara
hurriedly	jalxI
husbandry	pAlana
hydel	pana
hyderabad	hExarAbAxa
hydrate	hAidreta
hydrogenated	hAidrojaniwa
i.e.	arWAwa
iaf	vAyusenA
id	AIdI
idea-generation	vicAra-uwpAxana
ideas	AidiyA
identical	aBinna
identified	jAnA_jA
ignorant	ajFAnI
image	imeja
images	CaviyAM
imitating	imitetiMga
immeasurable	aparimeya
immediate	wawkAla
impact	asara
impartially	niRpakRa_rUpa_se
impetus	preraka
implementation	kriyAnvayana
important	mahawwva/pramuKa/jarUrI
improve	suXAra_kara
improved	behawara
improves	behawara_bana
in-depth	gahana
in-service	sevAkAlIna
inamgaon	inAmagAMva
incentive	iMseMtiva/prowsAhana
incentives	prowsAhana
income	Ayakara
income-tax	Ayakara
incoming	Avaka
incompetent	akRama
incremental	vqxXiSIla
incurable	lAilAja
independent	svAwanwra
indian	iMdiyana
indica	iMxikA
indicate	safkewa_xe/iMgiwa_kara
indicated	safkewa_xe
indira	iMxirA
indirectly	aprawyakRa_rUpa_meM
individual	akelA
individually	vyakwigawa_wOra_para
individuals	vyaRtiyAM
induce	preriwa
industrial	BArawIya/raKa
industrialized	Oxyogika
industries	Oxyogika/uxyoga
industry	Oxyogika
ineligible	asvIkqwa
infallible	acyuwa
influenced	praBAviwa
inform	bawA_xe
information	iMPoYrmeSana
informational	sUcanApraxa
infrastructural	saMsWAgawa
infrastructure	avasaMracanA/buniyAxI/suviXA
inhale	sAMsa_le
inherit	uwwarAXikAra
inheritance	vaMSagawa
initial	AramBika
injunction	niReXAxeSa
innovation	navAcAra
innovative	axaBuwa
innumerable	anaginawa
inputs	inaputa
inseparable	avicCexa
instance	uxAharaNArWa
instinctively	svaBAvawaH
institutes	saMsWAna
instrumental	nirNAyaka
instruments	liKawa
insult	apamAniwa_kara
insured	bImiwa
intact	sAbuwa
integrated	samanvikawa/samekiwa/ekIkqwa
intellect	buxXimawwA
intentionally	intenSanalI
inter-connectivity	anwara-samparka
inter-operability	anwaHkRamawA
inter-personality	anwara-vyakwiwva
interactive	iMtaraektiva
interdependent	paraspara_sambanXiwa
interest	rucikara
interface	iNtaraPesa
interior	iMtIriyara
internally	Anwarika
international	anwararARtrIya/vixeSI
intuitive	sahajAnuBUwa
invest	niveSa
invested	niveSiwa
investigation	jAFca
irritability	KIJa
issue	nirgama
issued	nirgamiwa
italic	itElika
item	cIja
iterative	punarAvqwwi
its	apanI
jammu	jammU
join	joda_xe
joyful	AnanxAyaka
jubilee	jublI
just	basa/sirPa
kerala	kerala
key	cABI/muKyo
kill	vaXa_kara
kind	prakAra
kindness	xayA
kinesthetic	kAinesWetika
kinsman	svajana
knowingly	jAnabUJakara
label	lebala
labelling	lebaliMga
labels	lebala
labor	Srama
lady	swrI
lamentation	Soka
landmark	lEMdamArka
large-term	laGukAlika
largely	aXiwakara/kAPI_haxa_waka
larval	lArvala
last	piCalI
lata	lawA
later	agale
latest	navInawama
launched	SurU_kara
laundry	loYndrI
lawful	yaxi
leading	agraNI
leads	praxAna_kara
leaflets	lIPaleta
learn	aXyayana_kara
learner's	larnarsa
learning	larniMga
least	alpawama
leaves	pawwA
legally	kAnUnI
legend	kiMvaxanwI
legislative	viXAyI/kAnUna
legitimate	nyAyociwa
legitimately	vEXa_rUpa_se
lesser	kama
letterhead	letaraheda
liability	xAvexArI
liberalized	uxAra
licensed	lAiseMsaprApwa
life	prANa
lifers	lAiParsa
lifting	liMPtiMga
ligament	asWi-rajjU
light	ilke
likely	samBAvanA
limited	limiteda
lines	pafkwiyAM
linguist	BARAvijFAnI
linguistic	BARAgawa
link	sambaXa
linked	juda/liMka
listed	sUcIbaxXa
listing	sUcIyana
live	sajIva
liveliness	jIvanwawA
living	jIvana
located	sWiwa
logistics	loYjistika
long-range	xIrGa-kAla
lord	BagavAna/loYrda
lose	Ko_bETa/kama_kara
losses	hAniyAM
lot	bahuwa
loudly	svara_se
lovely	pyArI
low-fat	vasA-yukwa
lower	nicalI
loyalty	vaPAxArI
luck	kismawa
luxuriously	vilAsiwApUrNa
macroeconomic	samaRti_arWaSAswrIya
macroeconomics	samaRti_arWaSAswra
maharana	mahArANA
mahendrapala-i	maheMxrapAla-praWama
mail	mela
mainly	muKyawaH
maintenance	raKaraKAva
make	meka
mama	mama
manage	prabanXana
management	mEnejameMta
manager	mEEnejara
managing	mEnejiMga
mandalay	maNdale
mandatory	mEndetrI
manners	mEnarsa
manual	mEnuala
manufacturers	vinirmAwA
manufacturing	vinirmANa
many	anekAneka
marginal	sImAnwIya
mark	afkiwa
marked	jabaraxaswa
marketing	mArkatiMga
maslow	mAslo
maslow's	mAslo
master	guru
materials	sAmagriyo
mean	arWa
means	mawalaba
meanwhile	isa_xOrAna
mechanical	mekenikala
mechanism	praNAlI/wanwra
medical	cikiwsakIya/ORaXIya/medikala
medicinal	xavAI
meditation	mediteSana
medium	mIdiyama/maXyama
medium-term	maXyama-avaXi/maXyAvaXika
meet	mulAkAwa_kara
megalithic	mahApARANakAlIna
member	sWApanA
membership	saxasya
mention	bawA/kaha_kara
mentioned	ulliKiwa
mentoring	meMtariMga
mercantile	vyApArika
merchandise	vANijyika
messaging	mesejiMga/sanxeSa
method	niyama
methods	praviXiyAM
microeconomics	vyaRti_arWaSAswra
mid-level	maXya-swara
mighty	parAkramI
mild	mqxu
millennial	mileniyala
mind	mAiMda
mindset	mAnasikawA
minimum	nyUnawama
minor	CotI
miscreant	xurAcArI
misrepresentation	bayAnI
mistake	galawa
mix	miSra
mobile	mobAila
modest	mAmUlI
modifications	parivarwana
modified	rUpAnwariwa
moisturizer	moYiscarAijara
money	rakama/rASi/rupae
monitor	nigarAnI
monitoring	moYnitariMga_kara/nigarAnI
monitors	nigarAnI
monocled	monokalda
monotonous	monotoYnasa
moroccan	morakko
mortgage	rehana
most	awyanwa/aXikawara
mostly	aXikAMSawaH
motivating	preraNAwmaka
mountain	parvawI
mountaineering	parvawArohaNa
move	gawimAna
movement	mUvamenta
mozambique	mojAmbika
mr.	SrI
multi	maltI
multi-country	bahu-xeSIya
multi-disciplinary	maltIdisiplinarI
multi-institutional	bahu-saMsWAgawa
multi-lines	maltI-lAina
multi-location	bahu-sWAna
multi-media	bahu-mAXyama/maltI-mIdiyA
multilingual	bahuBARAyI
multiplicity	guNAwmasakawA
municipal	nagarapAlikA
murud-janjira	muruxa-jaFjIrA
muscular	mAMsala
mushroom	maSarUma
musicians	safgIwajFa
mutation	uwparivarwana
mutations	myUteSana
nada	nAxa
nairobi	nErobI
namely	arWAw/nAmaka/arWAwa
national	neSanala/rARtraswarIya
native	sWAnIya
naturally	svABAvika_rUpa_se
nearby	pAsa
nearly	karIba
necessarily	jarUrI
neck	garxana
needed	AvaSyaka
negative	nakArAwmakawA
negotiation	bAwacIwa
neon	niyona
network	netavarka
networking	netavarkiMga
networks	netavarka
neutral	nyUtrala
nevertheless	iwane_para_BI
new	nae
newer	navInawara
newly-appointed	navaniyukwa
newsletters	nyUjaletarsa
next	agalI
nike's	nAikI
no.	safKyA
nodal	nodala
non-financial	gEra-viwwIya
non-loanee	gEra-qNI
non-metric	gEra-mEtrika
non-motivational	gEra-preraka
non-permanent	gEra-sWAyI
non-sustainable	gEra-tikAU
non-verbal	gEra-mOKika
nor	na_wo
normally	sAmAnya_rUpa_se/sAmAnyawayA/sAXAraNawaH
norms	mAnaka
northeastern	pUrvowwara
not	na_ki
notes	notsa/pawra
notified	aXisUciwa
noting	nota_kara
now	aba_se
now-a-days	Ajakala
nowadays	Ajakala
nullity	amAnya
numerous	kaI
obey	Axara_kara
obligation	kAnUna
octagonal	aRtakoNIya
offer	arpiwa/peSakaSa
offered	praxawwa
one-on-one	eka-eka
only	ekamAwra
openly	spaRta_rUpa_se
operational	paricAlanAwmaka
or	Ora/yA_Pira/evaM
order	niyama
orderly	vyavasWiwa
organic	jEvika
organise	vyavasWiwa_kara
organizational	safgaTanAwmaka
oriental	oYrieMtala
oriented	aBimuKI
orissa	udIsA
outage	Auteja
outdated	purAnI
outings	AutiMga
outsourcing	AutasorsiMga
overall	sarvAfgINa/pUrI
overdraft	ovaradrAPta
overly	awyaXika
overseas	saFcAlana
overview	avalokana
owned	svAmiwva
owner	svAmI
owners	svAmI
p	pI
packaging	pEkejiMga
page	pqRta
painful	xarxa
palm	pAma
pants	pEMta
para-military	arXa-sEnika
parallel	samAnwara
parameters	mAnaxaNda
parametric	pErAmItrika
paramount	sarvoparI
parapsychology	pErAsAyakAlAjI
parents	mAwA-piwA
part	kuCa
part-time	pArta-tAIma
participating	BAgIxAra
participatory	prawiBAgiwA
particularly	viSeRakara/KAsakara
parties	pakRa/pakRakAra
party	pakRa/pakRakAra
pass	bIwa/bIwa_cuka/niXana_ho_jA
passenger	savArI
passengers	savArI
passion	junUna
passport	posaporta
past	piCalI/pAsta
patent	peteMta
patents	peteMta
pawanmuktasana	pavanamukwAsana
pawnee	aXigrAhI
peculiar	vilakRaNa
peer	sAWI
pelvic	SroNi
percentage	PIsaxI/prawiSawa
perennial	niwya
perfect	uwwama
performance	parPoYrmensa/niRpAxana
performance-evaluation	praxarSana-mUlyAfkana
performer	nirvAhaka
perfume	suganXa
peril	joKima
period	kAlaH
periodic	AvaXika
periodically	samaya-samaya_para
permanent	sWAI
permissible	anumawa/svIkArya
permission	anumawi
permitted	anumawa
perquisites	anulabXiyAM
person	loga/iMsAna
personalized	parsanalAijda
personally	sAkRAw
persons	arWAw
pharmaceuticals	PArmAsyUtikalsa
phase	Peja
phenomenon	saMvqwi
pick	cunAva
pineapple	annAnAsa
pious	pAzco
place	sWala
planned	yojanAbaxXa
planning	plAniMga/niyojanA
plant	vqkRa
plantation	bAgAna
please	kqpyA/kqpA_kara
pledge	giravI
plenty	bahuwa_se
polarization	polarAija
policies	nIwiyAM
policy	nIwigawa/poYlisI
polished	poYliSa
politely	namrawA_se
polythene	poYliWina
popular	prasixXa
popularity	lokapriya
population	sanwAna
portability	portebilitI
position	manaHsWiwi
posture	Asana/hAvaBAva
potential	samBAvI
potentially	samBAviwa_rUpa_se
poultry	kukkuta
power	bijalI
powers	SakwiyAM
practically	prAyaH
pre-paid	prI-peda
pre-requisites	pUrva-AvaSyakawA
pre-set	prI-seta
precious	anamola
premium	prImiyama
prerequisite	pUrvAkAfkRiwa
prescribed	nirXAriwa
presentation	praswuwIkaraNa
prevention	niyanwraNa
primarily	pramuKa
primulas	prAimulasa
print	priMta_kara
printed	muxriwa
prioritize	prAWamikawA_kara
priority	prAWamika
private	prAiveta
pro-active	sakriya/awisakriya
problematic	samasyAgraswa
process	kAryapraNAlI
processing	prosesiMga/prasaMsAXana
procrastination	prokrAstineSana
procurement	aXiprApwi
produced	uwpAxiwa
producing	uwpAxaka
product	prodakta
production	uwpAnxana
profit-based	lABa-AXAriwa
profitable	lABapraxa/cAlU/lABArjaka
promises	vAyaxA
promissory	vacana
promotional	saMvarXanAwmaka
proper	saha/upayukwa
property	parisampawwi
proposed	praswAviwa
proprietor	svAmiwva
prostrate	prosteta
protect	saMrakRiwa_ho/surakRA_kara
protesters	praxarSanakAriya
prototype	prototAipa
proud	garva
proverb	kahAvawa
provide	mila
provides	upalabXa_kara/suviXA
psyche	mAnasa
psycho-social	mano-sAmAjika
public	sArvajAnika
publicly	sArvajanika_rUpa
pulp	gUxexAra/lugaxA
pulses	xAla
punch-marked	paFca-cihna
punished	xaNdiwa_kara
punjab	paFjAba
purifying	SuxXikaraNa
purport	wAwparya
purpose	prayojanArWa
qualified	nipuNa
quality	guNavawwApUrNa
quantitative	mAwrAwmaka
quarrel	Jagada
queen	rAjakumArI
query	pUCawACa
question	praSnaH
quick	wvariwa
quickly	jalxI_se
quiet	cupa
quite	sarvaWA
quotation	koteSana
rain	bAriSa_kara
rainfall	bAriSa/awivqRti/varRaNa
raja	rAja
ralph	rAlPa
rapid	wvariwa/wIvra
ras	Araeesa
rating	retiMga
rationally	warkasafgawa_rUpa_se
raw	kaccI
reach	pahuzca_jA
realistic	vAswavika
reason	vajaha
receipt	rasIxa
receivable	prApwama
receive	prApwa_ho
received	prApwa
recently	hAla_hI
recipient	prApwakarwwA
reclamation	riklemeSana
record	rikoYrda_kara
recording	rikoYrdiMga
records	rikoYrda
recreational	manoraFjaka
recruitment	BarwI/safGa/gEra-safGa
recruits	BarwI
recycle	punarcakraNa
red-line	reda-lAina
redemption	mocana
redness	lAlimA
reduced	kama
reeling	rIliMga
reference	rePareMsa
refined	saMSoXiwa_kara
reflective	rePalektiva
refuse	inakAra_kara
regeneration	vana/vikAsa
region-wise	kRewravAra
regional	praxeSa
registered	paFjIkqwa
regulatory	viniyAmaka
related	juda
relating	sambanXiwa
relative	sApekRika
release	rilIja/mukwa_ho
relevant	sambanXiwa
reliable	viSvesanIya
relocation	punarvAsa
remedy	samAXAna
repair	marammawa_kara
repeat	xoharAva
repeatedly	bAra-bAra
reports	riporta
require	AvaSyaka
rescue	rakRA
researchers	anusanXAnakarwA/SoXakarwA
residence	AvAsa
respectability	sammAna
respectful	sammAnajanaka
respective	sambanXiwa/sambaxXa
respiratory	Svasana
responsible	jimmemaxAra/jimmexArI
responsibly	jimmexArI_se
result	PalasvarUpa
resulting	pariNAmasvarUpa
resume	rijyUma
retail	ritela
retailer	ritelara
retire	sevAnivqwwa
return	vivaraNI
returns	vivaraNiyAM
reveal	prakata_ho
revenue	AmaxanI
reward	rivArda/inAma
rich	Xana
risk	safkata
risk-free	KawarA-rahiwa
rodent	rodanta
role-play	rola-ple
romani	romAnI
roof	rUPa
root-up	rUta-apa
ropes	rassA
ropeways	ropaveja
round	rAuNda
rude	asaBya
rupee	rupae
rupees	rupae
rva	AravIe
s	esa.
sa	sa
sac-cid-aananda-vigrahah	saccixAnanxa
sacrifice	yajFa
sage	qRi
saintly	sAXu
sales	selsa
salesperson	selsaparsana
salman	salamAna
salvaged	bacAI_jA
same	sAmAnarUpI/eka_hI
sameer	samIra
sanitary	sEnitarI
satisfaction	sanwuRti
satisfied	sanwuRtaka
satisfy	sanwuRta
saturated	sanwqpwa
scale	laGu
scare	BayaBIwa
scenario	parixqSya
scented	suganXiwa
scheduled	anusUciwa
scholars	aXyewA
screenings	cApaHniyamiwa/jAFca
seals	sIlsa
seat	AsIna
sebi	sebI
second	xUsarI/sekanda
secondly	xUsarI_bAwa
secretly	cupake_se
section	KaNda
secured	jamAnawI
see	XyAna_xe
selected	cuniMxAwa
self-assessment	Awma-mUlyAfkana
self-awareness	Awma-jAgarUkawA
self-doubt	Awma-sanxeha
self-esteem	Awma-sammAna/svABimAna
self-inquiry	AwmaparIkRaNa
self-knowledge	AwmajFAna
self-realization	Awma-sAkRAwkAra
self-regulation	svaviniyamana
self-serving	svayaMsevA
semi-circle	arXa-cakra
semi-private	arXa-nijI
senegalese	sinegalisa
senior	sIniyara
sense	iMxriya/BAvanA
separate	vilaga_kara
separately	alaga-alaga
series	SrqfKalA
seriously	gamBIrawApUrvaka
service	sArvisa
setting	setifga/sWApanA_kara
settlement	nipatAna
several	anekAneka
sharing	SeyariMga
shining	camacamA
shipping	nOvahana
shoot	mAra_xe
shopping	SoYpiMga
short	SoYrta
short-term	alpAvaXika
show	xiKA_raha/praxarSiwa_kara
significant	mahawvapUrNa
signifies	prawIka
silkworm	silkavoYrma
silver	cAnxI
similarly	usI_prakAra/isI_waraha
simply	basa
simulations	simuleSana
simultaneously	sAWa
since	cUfki
sinful	pApAwmA
singareni	sigarEnI
sir	SrImAna
sit	bETa_jA
six	Caha
sketching	skeciMga
skills	skilsa
slang	slEMga
slightly	WodA
slip	saraka_raha
slouch	Juka
slowly	XIre-XIre
small	CotI
smaller	CotI
smart	smArta
smile	hazsa_raha/muskurAhata
smiling	muskurAwI
smooth	sucAru
snapshot	snEpaSoYta
sneakers	snIkarsa
so	awaH/wo/isIlie
social	soSala
soft	narma
soft-hearted	komalahqxaya
software	sAPtaveyara
solely	kevala
solitude	akelepana
solution	javAba
some	kisI
sometimes	kaBI-kaBI
soon	SIGra_hI/jalxa_hI
south-west	xakRiNa-paScima
southeast	xakRiNa-pUrva
southwest	sAuWavesta
spawn	aNdA
speak	uccariwa_ho
specialized	viSeRa
specifically	KAsakara
specified	vinirxiRta/viSiRta
splendidly	SAnaxAra
spoken	spokana
sponsored	prAyojiwa
spoof	XoKA
spread	pahuFcAnA
squeaky	caramarAne
staffer	karmacArI
staffing	stAPiMga
standard	swarIya
started	Suru_kara
state	rAjyaswarIya
statement	stetameMta
station	wEnAwa
statistics	sAfKyikI
statutory	vEXAnika/sAMviXika
steal	curA_le
step	caraNa
steps	caraNa
stick	PaMsa_jA
sticky	stIkI
stiff	kadaka
stimulating	preriwa
stinging	cuBana
stock	stoYaka
stop	ruka_kara
storage	BaNdAra
stqc	esatIkyUsI
strain	jora
strategic	stretIjika/raNanIwika
strategy	kAryanIwi
strengthen	suxqDa
strengthening	majabUwa
strides	vqxXi
student	SiRya
sub-division	sabadivijana
subsequent	anuvarwI
subsidised	sabsidI
substantial	kAPI
successful	saPalawApUrvaka
such	EsI/jEsA/yaha
suddenly	sahasA
sugarcane	gannA
suited	upayukwa
sujata	sujAwA
summarizing	sArAMSIkaraNa
sun	suna
superior	behawara
supervisory	paryavekRaNa
supplier	ApUrwikarwA
support	saporta/sahAyaka/sahayoga
supportive	sahAyaka/sahayogAwmaka
sure	suniSciwa
surely	niSciwa_hI
surety	jamAnawaxAra
surrounded	GirA_ho
survivor	uwwaraxAyI
sustainable	nirvAhya
sword	svoYrda
syndication	siMdIkeSana
systematically	vyavasWiwa_rUpa_se
tactfully	cawurAI
tadasana	wAdAsana
talo-fibular	tEloPibulara
tanks	wAlAba
task	kArya/tAska
taskforce	kAryabala
tat	waw
tata	tAtA
tattva	wawwva
tax	Ayakara
teacher	AcArya/guru
teamwork	tImavarka
tears	aSru
technological	prOxyogikI
technologies	prOxyogikiyAM
technology	tEknoYlajI
telecom	telIkoYma
telecommunication	telIkamyUnikeSana
telemarketing	telImArketiMga
term	vAkya/xIrGAvaXika
terms	Sarwa
tesla	teslA
the	yaha
their	apanI
theistic	Aswika
them	vaha
thematic	WImetika/viRayagawa
then	punaH/Pira
there	vahIM_para
thereafter	paScAwa
therefore	isIlie/awaeva
thermal	wApa
they	vo
think	soca_raha
thinkers	WiMkarsa
thinking	WiMkiMga
third	wIsarI
thirteenth	werahavAM
thorium	Woriyama
thoroughly	acCI_waraha
thousand	hajArA
throw	PeMka_xe
thus	isa_prakAra_se/isIlie/awaH
time-bound	samayabaxXa
time-saving	samaya-bacawa
tip	sirA
tis	wIsa
title	hakaxArI
tools	yanwra
torpedo	wArapIdo
totally	pUrNarUpa_se/pUrI_waraha
touch	samparka
tourist	paryatana
towns	muKyAlaya
trace	Koja_kara
track	trEka_kara
trade	treda
traditionally	paramparAgawa_rUpa
trained	praSikRiwa
training	praSikRaNa
traits	lakRaNa
trans	trAMsa
transaction	lena-xena/lenaxena
transcendental	AXyAwmika/xivya
translation	BAvArWa
transmit	saFcariwa_kara
transportation	parivAhana
travel	gawi
treasury	koRa
tree	vqkRa
trees	vqkRa
trekking	trekiMga
tremendous	jabaraxaswa/bahuwa
trenches	KAiyAM
trends	rUJAna
trial	trAyala
tribal	janajAwi
trolled	trolda
trouble	pareSAna
truly	vAkaI/vAswavikawA_meM
trust	viSvAsa_kara
trustworthy	Barosemanxa
tu	wu
twist	GumA
two	xe
type	waraha
types	prajAwi
typing	tAipiMga
ultimate	parAkARTA
ultimately	AKirakAra/anwawaH
ultra	altrA
unarmed	nihawWA
unauthorized	aprAXikqwa
unclaimed	lAvArisa
uncomfortable	asuviXAjanaka
underground	aNdaragrAuNda
undermine	kamajora
understand	samaJa_raha/samaJa_jA
understandable	avaboXagamya
unfortunately	xurBAgyavaSa
unhappy	nAKuSa/xuKI
unicef	yunisePa
uniform	yUniPoYrma
union	yUniyana
unique	anUTI/anoKI/viralA
unit	BAga/yUnita
unitary	ekAwmaka
united	yUnAiteda
units	yUnita
unjustifiable	anuciwa
unlawful	gEra-kAnUnI
unnecessarily	anAvaSyaka_rUpa
unpredictable	aprawyASiwa
unravelling	sulaJAnA
unscrupulous	beImAna
unsecured	aprawiBUwa
unseen	anaxeKI
unselfish	nisvArWa
until	wAki
untrustworthy	aviSvasanIya
unwilling	vimuKa
updates	apadeta
upper	UparI
upsc-union	yUpIesasI-safGa
uranium-plutonium	yUreniyama-plUtoniyama
urgently	wawkAla
useful	yUjaPula
user	prayokwA/sevA/upayogakarwA
ushtrasana	uRtrAsana
usually	AmawOra_para/aksara/sAXAraNawaH
utilised	prayukwa/upayoga
utility	yUtilitI
utilization	upayogiwA
utilize	upayoga
utkatasana	uwkatAsana
values	vElyUja
valves	vAlvsa
varied	viviXa
various	kaI/viBinn
vast	anekAneka/vyApaka
vegetables	sabjiyAM
vein	nasa
vendor-consumer	vikrewA-upaBokwA
verify	veriPAI/veriPAI_kara
vickey	vikI
victory	jaya/jIwa
visakhapatnam	viSAKApattanama
vision	xqRtikoNa
visitors	vijitarsa
visualization	vijualAijeSana
visually	xqRtigawa_rupa_se
vital	mahawvapUrNa
viz.	vyafkwi
vocational	vokeSanala
void	amAnya
vrikshasana	vqkRAsana
vulnerable	awi-saMvexanaSIla
wait	iMwajAra_kara
wanted	vANteda
warehouse	BaNdArAgAra
warehouses	BaNdArAgAra
warranty	vAraNtI
waste	barbAxa
water	vAtara/pA
watershed	vAtaraSeda
way	viXi
weaknesses	kamajoriyoM
weaning	vIniMga
weaponless	haWiyArahiwa
website	vebasAita
well	suvikasiwa
well-defined	supariBARiwa
well-known	prasixXa
were	hE/WA
what	kOna-sI
whenever	jaba_BI
whereby	jo
wherein	jo
while	jabaki
who	jina
whole	sArA/sampUrNa
whom	kOna
whose	jo
why	kya
widely	vyApaka_rUpa
wild	jafgalA
win	jIwa_le
winsome	manamohaka
wipes	vAIpsa
wisely	buxXimAnI_se
woke	jAga_jA
wont	nahIM
workforce	kAryabala
working	kAmakAjI/kAryacAlana/kAryaSIla
worksheet	kAryapawraka
worldwide	xuniyA_Bara_meM
worms	kIta
worthier	yogya
writing	liKiwa
yam	yama
year	varRIya
yes	jI
yet	aBI_waka
young	CotI
your	wU
